set AF AFN	
set AX	EUR	
set AL	ALL
set DZ	DZD
set AS	USD
set AD	EUR
set AO	AOA
set AI	XCD
set AG	XCD
set AR	ARS
set AM	AMD
set AW	AWG
set AZ	AZN
set BS	BSD
set BH	BHD
set BD	BDT
set BB	BBD
set BY	BYN
set BE	EUR
set BZ	BZD
set BJ	XOF
set BM	BMD
set BT	BTN
set BO	BOB
set BA	BAM
set BW	BWP
set BV	NOK
set BR	BRL
set IO	USD
set VG	USD
set BN	BND
set BG	BGN
set BF	XOF
set BU	BUK
set BI	BIF
set KH	KHR
set CM	XAF
set CA	CAD
set IC	EUR
set CV	CVE
set BQ	USD
set KY	KYD
set CF	XAF
set EA	EUR
set TD	XAF
set CL	CLP
set CN	CNY
set CX	AUD
set CC	AUD
set CO	COP
set KM	KMF
set CG	XAF
set CD	CDF
set CK	NZD
set CR	CRC
set CI	XOF
set HR	HRK
set CU	CUP
set CW	ANG
set CY	EUR
set YD	YDD
set DK	DKK
set DG	USD
set DJ	DJF
set DM	XCD
set DO	DOP
set TP	TPE
set EC	USD
set EG	EGP
set SV	USD
set GQ	XAF
set ER	ERN
set EE	EUR
set ET	ETB
set FK	FKP
set FO	DKK
set FJ	FJD
set FI	EUR
set FR	EUR
set GF	EUR
set PF	XPF
set TF	EUR
set GA	XAF
set GM	GMD
set GE	GEL
set DE	EUR
set GH	GHS
set GI	GIP
set GR	EUR
set GL	DKK
set GD	XCD
set GP	EUR
set GU	USD
set GT	GTQ
set GG	GBP
set GN	GNF
set GW	XOF
set GY	GYD
set HT	HTG
set HM	AUD
set HN	HNL
set HK	HKD
set HU	HUF
set IS	ISK
set IN	INR
set ID	IDR
set IR	IRR
set IQ	IQD
set IE	EUR
set IM	GBP
set IL	ILS
set IT	EUR
set JM	JMD
set JP	JPY
set JE	GBP
set JO	JOD
set KZ	KZT
set KE	KES
set KI	AUD
set XK	EUR
set KW	KWD
set KG	KGS
set LA	LAK
set LV	EUR
set LB	LBP
set LS	ZAR
set LR	LRD
set LY	LYD
set LI	CHF
set LT	EUR
set LU	EUR
set MO	MOP
set MK	MKD
set MG	MGA
set MW	MWK
set MY	MYR
set MV	MVR
set ML	XOF
set MT	EUR
set MH	USD
set MQ	EUR
set MR	MRO
set MU	MUR
set YT	EUR
set MX	MXN
set FM	USD
set MD	MDL
set MC	EUR
set MN	MNT
set ME	EUR
set MS	XCD
set MA	MAF
set MZ	MZN
set MM	MMK
set NA	NAD
set NR	AUD
set NP	NPR
set NL	EUR
set NC	XPF
set NZ	NZD
set NI	NIO
set NE	XOF
set NG	NGN
set NU	NZD
set NF	AUD
set KP	KPW
set MP	USD
set NO	NOK
set OM	OMR
set PK	PKR
set PW	USD
set PS	ILS
set PA	PAB
set PG	PGK
set PY	PYG
set PE	PEN
set PH	PHP
set PN	NZD
set PL	PLN
set PT	EUR
set PR	USD
set QA	QAR
set RE	EUR
set RO	RON
set RU	RUB
set RW	RWF
set WS	WST
set SM	EUR
set ST	STN
set SA	SAR
set SN	XOF
set RS	RSD
set CS	CSD
set SC	SCR	
set SL	SLL
set SG	SGD
set SX	ANG
set SK	EUR
set SI	EUR
set SB	SBD
set SO	SOS
set ZA	ZAR
set GS	GBP
set KR	KRW
set SS	SSP
set ES	EUR
set LK	LKR
set BL	EUR
set SH	SHP
set KN	XCD
set LC	XCD
set MF	EUR
set PM	EUR
set VC	XCD
set SD	SDG
set SR	SRD
set SJ	NOK
set SZ	SZL
set SE	SEK
set CH	CHF
set SY	SYP
set TW	TWD	
set TJ	TJS
set TZ	TZS
set TH	THB
set TL	USD
set TG	XOF
set TK	NZD
set TO	TOP
set TT	TTD
set TA	GBP
set TN	TND
set TR	TRY
set TM	TMT
set TC	USD
set TV	AUD
set UM	USD
set VI	USD
set UG	UGX
set UA	UAH
set AE	AED
set GB	GBP
set US	USD
set UY	UYU
set UZ	UZS
set VU	VUV
set VA	EUR
set VE	VEF
set VN	VND
set WF	XPF
set EH	MAD
set YE	YER
set ZR	ZRN
set ZM	ZMW
set ZW	USD

